12 25 1 1 41  1 25 25 1 1 1 4 1 25 25 1 1 1
1 31 1 1 42  1 1 1 1 31 1 1 1 1 1 4 1 1
1 25 4 1 43  1 1 14 1 1 4 25 1 31 1 1 1 1 
25 1 1 1 44  1 21 1 25 25 25 1 1 1 1 1 1 1
1 1 25 1 45 1 25 1 4 1 1 31 1 14 1 1 25 
49 48 47 46 40 42 40  1 1 1 1 1 1
1 25 25 1 1 1 21 1 1 48  1 1 1 1 16 1 1 1
1 1 6 1 31 1 1 1 1 50  1 31 1 1 25 1 1 1
1 1 1 1 1 1 21 1 1 51  1 1 17 1 1 1 1 1
25 25 1 1 4 1 24 24 1 52  1 31 1 1 31 1 1 1
1 1 7 1 1 1 1 1 1 54  1 1 1 1 21 1 1 1
1 23 1 22 25 1 7 1 1  40 1 1 1 25 1 1 1 1 1
1 1 1 1 1 21 1 1 1 41 42 43 44 45 46 47 48 49
1 1 31 1 1 1 1 1 1 40  1 1 1 1 1 1 1 1
49 48 47 46 40 42 40 40 40 49 40 48 1 1 1 25 25 25 25 1 1
1 25 25  1 1 1 1 31 1  51 1 1 1 31 1 1 1 1
1 1 1 21 1 1 1 1 1  50 1 31 1 1 25 1 1 1
1 1 1 1 1 1 31 1 1  60 1 1 1 1 1 1 31 1 1 1
